C 139, 0, 0   
NO ./Users/ehande/Desktop/cub3d/dop_files/WALL78.xpm
EA ./Users/ehande/Desktop/cub3d/dop_files/WALL16.xpm
S ./Users/ehande/Desktop/cub3d/dop_files/pofficer_w1_1.xpm
SO ./Users/ehande/Desktop/cub3d/dop_files/WALL66.xpm
WE ./Users/ehande/Desktop/cub3d/dop_files/WALL71.xpm
F 0, 0, 0
R 800 600
111111111111111111111111111111111
100000000000100000000000000000001
10000W000000100000000000000000001
100000000000100000000000000000001
100000000000100000000000000000001
100000000000100000000000000000001
100000200000100000000000000000001
100000000000100020000000000000001
100000000000100000000000000000001
100000000000111111101111111111111
100000000000000000001111111111111
111111111011111111001111111111111
100000001110000000001111111111111
100000000000000011111111111111111
100000000000000011111111111111111
100000000200000011111111111111111
100000000000000000000000000000001
100000000000000000000000000000001
100000000000000002000000000000001
100000000000000000000000000000001
111111111111111111111111111111111